########
#      #
/      /
###/####
--
####/#########
#   |        #
#   |        /
#   |#########
/   |  #
####/###
--
###/####
#  |   #
#  |   /
#  |####
#  |   # 
#  |   #
/  |   #
########
--
#######       #######
/ |   #       #     #
##|   ####/####     #
# |       |         #
/ |       |         /
#####################
--
####################
#           |      #
/           |      /
############|#############
       #    |            #
       /    |            /
       ###################
--
################
#|             /
#|##############
#|     #
#|     #
#|     #
#|######
#|     #
#|     #
#|     /
########
--
######
/   |#
####|#
/   |#
#|####
#|   #
#|   #
#|   #
/|   #
######
--
########################
#                      #
#                      #
#                      #
#                      #
############/###########
--
#####/####
#        #
#        /
##########