########
#      #
/      /
###/####
--
####/#########
#   |        #
#   |        /
#   |#########
/   |  #
####/###
--
###/####
#  |   #
#  |   /
#  |####
#  |   # 
#  |   #
/  |   #
########
--
#######       #######
/ |   #       #     #
##|   ####/####     #
# |       |         #
/ |       |         /
#####################
--
####################
#           |      #
/           |      /
############|#############
       #    |            #
       /    |            /
       ###################
--
################
#|             /
#|##############
#|     #
#|     #
#|     #
#|######
#|     #
#|     #
#|     /
########
--
######
/   |#
####|#
/|  |#
#|####
#|   #
#|   #
#|   #
/|   #
######
--
########################
#                      #
#                      #
#                      #
#                      #
############/###########
--
#####/####
#        #
#        /
##########
--
#/#
#|#
#|#
#|#
#/#
--
#####/#
#    |#
/    |#
#/#####
--
############
#    |    |/
#####|    |#########
#    |    |        /
####################
--
###################
/    |  #         #
#####|  #         #
    #|  #         #
    #|###         #
    /|            #
    #############/#
--
##########/#########
#         |        #
#         |        #
####################
--
#######
/    |/
#####|#
    #|#
    #|#
    #|#
    #|#
    #|#
    #|#
    #|#
    /|/
    ###
--
###
/|#
#|#
#|#
#|#
#|#
#|/
###